  ;  ;  ;R1;  ;R3;  ;  ;  ;  
  ;  ;  ;  ;  ;  ;  ;  ;  ;  
  ;  ;  ;  ;  ;  ;  ;  ;  ;  
  ;  ;  ;  ;  ;  ;  ;  ;  ;  
  ;  ;  ;R1;  ;R3;C2;  ;C2;  
  ;  ;  ;  ;  ;Tc;  ;  ;J2;  
J1;C1;  ;C1;Tb;  ;  ;  ;  ;  
  ;  ;  ;  ;  ;Te;  ;  ;J2;  
J1;  ;  ;R2;  ;R4;C3;  ;  ;  
  ;  ;  ;  ;  ;  ;  ;  ;  ;  
  ;  ;  ;  ;  ;  ;  ;  ;  ;  
  ;  ;  ;  ;  ;  ;  ;  ;  ;  
  ;  ;  ;R2;  ;R4;C3;  ;  ;  
  ;  ;  ;  ;  ;  ;  ;  ;  ;  
  ;  ;  ;  ;  ;  ;  ;  ;  ;  
